year;Angola;Burundi;Benin;Burkina_Faso;Botswana;Central_African_Republic;Cote_d_Ivoire
2011;192;63;423;289;139;671;619
2012;4470;48;285;803;10;67;152
2013;6564;0;757;422;1;370;47
2014;12002;8;761;419;88;210;50
2015;103;7;53;99;2;123;45
2016;51;16;98;223;2;191;54
2017;27;18;192;45;0;73;164
2018;57;10;886;1682;2;29;574
2019;2962;30;502;767;0;419;428